11111111111111
1000000C000001
1000P0000000E1
11111111111111